28
48
1
MMMMMMMMMMMMMMMMMMMMMMMMMMMMMMMMMMMMMMMMMMMMMMMM
MMMMMMMMMMMMMMMMMMMMMMMMMMMMMMMMMMMMMMMMMMMMMMMM
MMMMMMMMMMMMMMMMMMMMMMMMMMMMMMMMMMMMMMMMMMMMMMMM
MMMM||||||||||||||||||||||||||||||||||||||||MMMM
MMMM|MMMMMM_MMDMO_MMMMMOMOMMMMMMM_MMMMOMMML|MMMM
MMMM|MOHOMMMMMM_MMMMMMMMMODMMOMMMM_MMMMM_MM|MMMM
MMMM|MMMMMMMMMM_MM_MMMMMOMOMMOMMMMMMMMOMMMM|MMMM
MMMM|OM__MMMMMMMMMOMMMMMMOMMOMMMMOMMMOMMMMM|MMMM
MMMM|OMOOMMMMMMMMMOOMMOMMMMMMMMOMMMMMMOMO_M|MMMM
MMMM|MMMOMMOMMMMMMMMOMMMMMOM_OMMMMMMMMOMOOM|MMMM
MMMM|||||||||||||||||||||||||||||||MMMOMMOM|MMMM
MMMM|M_MMMOMMDM_MMOMOMMMMMMMMMMDMO_MMMMMMOM|MMMM
MMMM|MMDMMMMMOMMMMM_MMMMMMMMO__OMMDMMMMOMMM|MMMM
MMMM|MMMOMMOMOMMMMMMMMMMMMMMOOMOMMOMMMMMMMM|MMMM
MMMM|M_OMMMMOMMMMMMMMOO_MMMMMMMOMMOMDMMMM_M|MMMM
MMMM|MOMM_MMOM__MMMMMOMODMMDMMMMOMMMOMMDMOM|MMMM
MMMM|MDOMMMMMMMMMMMMMMOOOMMOMMMMMMMMDMMMMMO|MMMM
MMMM|MMMMMMMM|||||||||||||||||||||||||||||||MMMM
MMMM|__MMMMMMMMM_MMMDMMMMOMMMMMOMMMOMMMMMMM|MMMM
MMMM|OOMMMMMMMMMOOMMOMMMMMMMMOMMMMMMOMO_MME|MMMM
MMMM|MOMMOMMMMMMMMOMMMMMOM__MMMMDMMMOMOOMMM|MMMM
MMMM|MMMMODMM_MMMMMMMMOMMMMMMOMODMMMMMMOMMM|MMMM
MMMM|MMM_MM_MOMMOMOOMMMMMMMMMOMODMMMMMMOMMO|MMMM
MMMM|MDMMMMOMMMMM_MMMMMMMMM_MOMMOMOMMMRMMOM|MMMM
MMMM||||||||||||||||||||||||||||||||||||||||MMMM
MMMMMMMMMMMMMMMMMMMMMMMMMMMMMMMMMMMMMMMMMMMMMMMM
MMMMMMMMMMMMMMMMMMMMMMMMMMMMMMMMMMMMMMMMMMMMMMMM
MMMMMMMMMMMMMMMMMMMMMMMMMMMMMMMMMMMMMMMMMMMMMMMM